22000000202220
02222222222020
22000200022220
02202202220022
00222000200222
02202202220202
22000222020202
02202200022202
00222002222222
02202222000020
02002002022220
22022222002000
20000002022220
22222222222000