11100001000000
10101111011111
10101001111011
10101100001011
10111001111011
10001101111001
11101111011111
00101110001001
11101111011011
10101001010111
10101001110100
10111101000101
10111101111101
10011111001111